   _ _ _ _ _ _ _ _ _ _ _ _ _ _ _ _ _ _ _ _ _ _ _ _
01|#|#|#|#|#|#|_|_|_|0|#|#|#|#|1|_|_|_|#|#|#|#|#|#|
02|#|K|K|K|K|#|_|_|#|#|#|B|B|#|#|#|_|_|#|C|C|C|C|#|
03|#|K|K|K|K|#|_|_|#|B|B|B|B|B|B|#|_|_|#|C|C|C|C|#|
04|#|K|K|K|K|#|_|_|#|B|B|B|B|B|B|#|_|_|#|C|C|C|C|#|
05|#|K|K|K|K|#|_|_|#|B|B|B|B|B|B|#|_|_|#|C|#|C|C|#|
06|#|#|#|#|K|#|_|_|B|B|B|B|B|B|B|B|_|_|_|_|#|#|#|#|
07|_|_|_|_|_|_|_|_|#|#|B|#|#|B|#|#|_|_|_|_|_|_|_|2|
08|_|_|_|_|_|_|_|_|_|_|_|_|_|_|_|_|_|_|_|_|_|_|_|_|
09|#|#|#|#|_|_|_|_|_|_|_|_|_|_|_|_|_|_|#|#|#|#|#|#|
10|#|D|D|#|#|#|#|_|_|#|#|#|#|#|#|_|_|_|#|A|A|A|A|#|
11|#|D|D|D|D|D|#|_|_|#|#|#|#|#|#|_|_|_|A|A|A|A|A|#|
12|#|D|D|D|D|D|D|_|_|#|#|#|#|#|#|_|_|_|#|A|A|A|A|#|
13|#|D|D|D|D|D|#|_|_|#|#|#|#|#|#|_|_|_|#|#|#|#|A|#|
14|#|D|D|D|D|D|#|_|_|#|#|#|#|#|#|_|_|_|_|_|_|_|_|_|
15|#|D|D|D|D|D|#|_|_|#|#|#|#|#|#|_|_|_|#|#|L|#|#|#|
16|#|#|#|#|D|#|#|_|_|#|#|#|#|#|#|_|_|#|#|L|L|L|L|#|
17|_|_|_|_|_|_|_|_|_|#|#|#|#|#|#|_|_|L|L|L|L|L|L|#|
18|5|_|_|_|_|_|_|_|_|_|_|_|_|_|_|_|_|#|#|L|L|L|L|#|
19|_|_|_|_|_|_|_|_|#|#|H|H|H|#|#|_|_|_|#|#|#|#|#|#|
20|#|#|#|#|E|#|_|_|#|H|H|H|H|H|#|_|_|_|_|_|_|_|_|3|
21|#|E|E|E|E|#|_|_|#|H|H|H|H|H|H|_|_|_|_|_|_|_|_|_|
22|#|E|E|E|E|#|_|_|#|H|H|H|H|H|#|_|_|#|S|#|#|#|#|#|
23|#|E|E|E|E|#|_|_|#|H|H|H|H|H|#|_|_|#|S|S|S|S|S|#|
24|#|E|E|E|E|#|_|_|#|H|H|H|H|H|#|_|_|#|S|S|S|S|S|#|
25|#|#|#|#|#|#|4|_|#|#|#|#|#|#|#|_|_|#|#|#|#|#|#|#|
   A B C D E F G H I J K L M N O P Q R S T U V W X
